const cells2 = [
    [1,1,1,1,1,1,1,1,1,1,1,1,1,1,1,1,1,1,1,1,1,1,1],
    [1,0,0,0,1,0,0,0,0,0,0,0,0,0,0,0,0,0,1,0,0,0,1],
    [1,0,1,0,1,0,1,1,1,1,1,0,1,1,1,1,1,0,1,0,1,0,1],
    [1,0,0,0,0,0,0,0,1,0,0,0,0,0,1,0,0,0,0,0,0,0,1],
    [1,1,1,0,1,0,1,0,1,0,1,1,1,0,1,0,1,0,1,0,1,1,1],
    [1,0,0,0,1,0,1,0,1,0,1,4,1,0,1,0,1,0,1,0,0,0,1],
    [1,0,1,0,1,0,1,0,1,0,1,1,1,0,1,0,1,0,1,0,1,0,1],
    [1,0,0,0,1,0,1,0,0,0,0,0,0,0,0,0,1,0,1,0,0,0,1],
    [1,1,1,1,1,0,1,0,1,1,1,1,1,1,1,0,1,0,1,1,1,1,1],
    [1,0,0,0,0,0,1,0,4,4,4,4,4,4,4,0,1,0,0,0,0,0,1],
    [1,4,1,1,1,1,1,0,1,1,1,4,1,1,1,0,1,1,1,1,1,4,1],
    [0,0,0,0,0,0,0,0,1,2,2,4,2,2,1,0,0,0,0,0,0,0,0],
    [1,4,1,1,1,1,1,0,1,1,1,1,1,1,1,0,1,1,1,1,1,4,1],
    [1,0,0,0,0,0,1,0,4,4,4,4,4,4,4,0,1,0,0,0,0,0,1],
    [1,1,1,1,1,0,1,0,1,1,1,1,1,1,1,0,1,0,1,1,1,1,1],
    [1,0,0,0,1,0,1,0,0,0,0,0,0,0,0,0,1,0,1,0,0,0,1],
    [1,0,1,0,1,0,1,0,1,0,1,1,1,0,1,0,1,0,1,0,1,0,1],
    [1,0,0,0,1,0,1,0,1,0,1,4,1,0,1,0,1,0,1,0,0,0,1],
    [1,1,1,0,1,0,1,0,1,0,1,1,1,0,1,0,1,0,1,0,1,1,1],
    [1,0,0,0,0,0,0,0,1,0,0,0,0,0,1,0,0,0,0,0,0,0,1],
    [1,0,1,0,1,0,1,1,1,1,1,0,1,1,1,1,1,0,1,0,1,0,1],
    [1,0,0,0,1,0,0,0,0,0,0,0,0,0,0,0,0,0,1,0,0,0,1],
    [1,1,1,1,1,1,1,1,1,1,1,1,1,1,1,1,1,1,1,1,1,1,1],
]// 0 - pac-dots, 1 - walls, 2 - ghosts,3 - pac-man, 4 - empty 