let cells = [
	[1,1,1,1,1,1,1,1,1,1,1,1,1,1,1,1,1,1,1,1,1,1,1,1,1,1,1,1],
	[1,0,0,0,0,0,0,0,0,0,0,0,0,1,1,0,0,0,0,0,0,0,0,0,0,0,0,1],
    [1,0,1,1,1,1,0,1,1,1,1,1,0,1,1,0,1,1,1,1,1,0,1,1,1,1,0,1],
    [1,0,1,1,1,1,0,1,1,1,1,1,0,1,1,0,1,1,1,1,1,0,1,1,1,1,0,1],
    [1,0,1,1,1,1,0,1,1,1,1,1,0,1,1,0,1,1,1,1,1,0,1,1,1,1,0,1],
    [1,0,0,0,0,0,0,0,0,0,0,0,0,0,0,0,0,0,0,0,0,0,0,0,0,0,0,1],
    [1,0,1,1,1,1,0,1,1,1,1,1,1,1,1,1,1,1,1,1,1,0,1,1,1,1,0,1],
    [1,0,1,1,1,1,0,1,1,1,1,1,1,1,1,1,1,1,1,1,1,0,1,1,1,1,0,1],
    [1,0,0,0,0,0,0,0,0,0,0,0,0,1,1,0,0,0,0,0,0,0,0,0,0,0,0,1],
    [1,1,1,1,1,1,0,1,1,1,1,1,0,1,1,0,1,1,1,1,1,0,1,1,1,1,1,1],
    [1,1,1,1,1,1,0,1,1,4,4,4,4,4,4,4,4,4,4,1,1,0,1,1,1,1,1,1],
    [1,1,1,1,1,1,0,1,1,4,1,1,4,4,4,4,1,1,4,1,1,0,1,1,1,1,1,1],
    [1,1,1,1,1,1,0,1,1,4,1,2,4,4,4,4,2,1,4,1,1,0,1,1,1,1,1,1],
    [4,4,4,4,4,4,0,0,0,4,1,4,4,4,4,4,4,1,4,0,0,0,4,4,4,4,4,4],
    [1,1,1,1,1,1,0,1,1,4,1,2,4,4,4,4,2,1,4,1,1,0,1,1,1,1,1,1],
    [1,1,1,1,1,1,0,1,1,4,1,1,1,1,1,1,1,1,4,1,1,0,1,1,1,1,1,1],
    [1,1,1,1,1,1,0,1,1,4,1,1,1,1,1,1,1,1,4,1,1,0,1,1,1,1,1,1],
    [1,0,0,0,0,0,0,0,0,4,4,4,4,4,3,4,4,4,4,0,0,0,0,0,0,0,0,1],
    [1,0,1,1,1,1,0,1,1,1,1,1,0,1,1,0,1,1,1,1,1,0,1,1,1,1,0,1],
    [1,0,1,1,1,1,0,1,1,1,1,1,0,1,1,0,1,1,1,1,1,0,1,1,1,1,0,1],
    [1,0,0,0,1,1,0,0,0,0,0,0,0,0,0,0,0,0,0,0,0,0,1,1,0,0,0,1],
    [1,1,1,0,1,1,0,1,1,0,1,1,1,1,1,1,1,1,0,1,1,0,1,1,0,1,1,1],
    [1,1,1,0,1,1,0,1,1,0,1,1,1,1,1,1,1,1,0,1,1,0,1,1,0,1,1,1],
    [1,0,0,0,0,0,0,1,1,0,0,0,0,1,1,0,0,0,0,1,1,0,0,0,0,0,0,1],
    [1,0,1,1,1,1,1,1,1,1,1,1,0,1,1,0,1,1,1,1,1,1,1,1,1,1,0,1],
    [1,0,1,1,1,1,1,1,1,1,1,1,0,1,1,0,1,1,1,1,1,1,1,1,1,1,0,1],
    [1,0,0,0,0,0,0,0,0,0,0,0,0,0,0,0,0,0,0,0,0,0,0,0,0,0,0,1],
    [1,1,1,1,1,1,1,1,1,1,1,1,1,1,1,1,1,1,1,1,1,1,1,1,1,1,1,1]